WWWWWWWWWWWWWWWWWWWWW
WWWOOOOOOOUUUUUUSWWWW
WWWOOOOOOOOWWWWWWWWWW
WWWOOOOOOOUUUUUUUUUWW
WWWOOOOOOOOWWWWUUUUWW
WWWOOOOOOOUUUUUUUGUWW
WWWOOOOOOOOWWWWUUUUWW
WWWOOOOOOOUUUUUUUUUWW
WWWOOOOOOOOWWWWWWWWWW
WWWOOOOOOOOOOOOOOOWWW
WSWOOOOOOOOOOOOOWUWWW
WUWOOOOOOOOOOOOWWUWWW
WUWOOOOOOOOOOOOWWUWWW
WUUOOOOOOOOOOOOWWUWWW
WUUOOOOOOOOOOOOWWUWWW
WWWWWWWWWWWWWWWWWSWWW
